"filename", "language", "TypeScript", "PostCSS", "vue", "comment", "blank", "total"
"f:\Project\RBlog\RBlog_F\components.d.ts", "TypeScript", 1, 0, 0, 0, 0, 1
"f:\Project\RBlog\RBlog_F\src\components\FeelingCard\FeelingCard.vue", "vue", 0, 0, 131, 9, 11, 151
"f:\Project\RBlog\RBlog_F\src\hooks\useFeelingCard\useFeelingCard.ts", "TypeScript", 139, 0, 0, 18, 21, 178
"f:\Project\RBlog\RBlog_F\src\hooks\useFeelingPage\useFeelingPage.ts", "TypeScript", 15, 0, 0, 0, 4, 19
"f:\Project\RBlog\RBlog_F\src\hooks\useFeelingPage\useFeelingScrollPage\useFeelingScrollPage.ts", "TypeScript", 38, 0, 0, 0, 6, 44
"f:\Project\RBlog\RBlog_F\src\pages\FeelingPage\FeelingPage.vue", "vue", 0, 0, 30, 1, 5, 36
"f:\Project\RBlog\RBlog_F\src\pages\FeelingPage\FeelingScrollPage\FeelingScrollPage.vue", "vue", 0, 0, 21, 0, 4, 25
"f:\Project\RBlog\RBlog_F\src\router\index.ts", "TypeScript", 1, 0, 0, 0, 0, 1
"f:\Project\RBlog\RBlog_F\src\styles\feeling-card\feeling-card.css", "PostCSS", 0, 158, 0, 6, 27, 191
"f:\Project\RBlog\RBlog_F\src\styles\feeling-page\feeling-page.css", "PostCSS", 0, 200, 0, 8, 29, 237
"f:\Project\RBlog\RBlog_F\src\styles\feeling-page\feeling-scroll-page\feeling-scroll-page.css", "PostCSS", 0, 71, 0, 10, 10, 91
"f:\Project\RBlog\RBlog_F\src\types\index.ts", "TypeScript", 15, 0, 0, 0, 1, 16
"Total", "-", 209, 429, 182, 52, 118, 990