"filename", "language", "TypeScript", "PostCSS", "vue", "MS SQL", "comment", "blank", "total"
"f:\Project\RBlog\RBlog_F\components.d.ts", "TypeScript", -8, 0, 0, 0, 0, 0, -8
"f:\Project\RBlog\RBlog_F\database\schema.sql", "MS SQL", 0, 0, 0, 42, 7, 5, 54
"f:\Project\RBlog\RBlog_F\src\components\AboutArticleCard\AboutArticleCard.vue", "vue", 0, 0, 27, 0, 0, 3, 30
"f:\Project\RBlog\RBlog_F\src\components\FeelingCard\FeelingCard.vue", "vue", 0, 0, 31, 0, 0, 5, 36
"f:\Project\RBlog\RBlog_F\src\components\MessageCard\MessageCard.vue", "vue", 0, 0, 165, 0, 11, 11, 187
"f:\Project\RBlog\RBlog_F\src\hooks\useAboutPage\useAboutPage.ts", "TypeScript", 34, 0, 0, 0, 6, 7, 47
"f:\Project\RBlog\RBlog_F\src\hooks\useArticlePage\useCategorySignal\useCategorySignal.ts", "TypeScript", 1, 0, 0, 0, 0, 0, 1
"f:\Project\RBlog\RBlog_F\src\hooks\useFeelingCard\useFeelingCard.ts", "TypeScript", -11, 0, 0, 0, -2, -4, -17
"f:\Project\RBlog\RBlog_F\src\hooks\useHomeScrollPage\useHomeScrollPage.ts", "TypeScript", -2, 0, 0, 0, 0, 0, -2
"f:\Project\RBlog\RBlog_F\src\hooks\useInfoCard\useInfoCard.ts", "TypeScript", 0, 0, 0, 0, 1, 0, 1
"f:\Project\RBlog\RBlog_F\src\hooks\useMessageCard\useMessageCard.ts", "TypeScript", 161, 0, 0, 0, 25, 22, 208
"f:\Project\RBlog\RBlog_F\src\hooks\useMessagePage\useMessagePage.ts", "TypeScript", 28, 0, 0, 0, 1, 4, 33
"f:\Project\RBlog\RBlog_F\src\hooks\useMessagePage\useMessageScrollPage\useMessageScrollPage.ts", "TypeScript", 48, 0, 0, 0, 1, 7, 56
"f:\Project\RBlog\RBlog_F\src\pages\AboutPage\AboutPage.vue", "vue", 0, 0, 36, 0, 0, 5, 41
"f:\Project\RBlog\RBlog_F\src\pages\MessagePage\MessagePage.vue", "vue", 0, 0, 30, 0, 1, 5, 36
"f:\Project\RBlog\RBlog_F\src\pages\MessagePage\MessageScrollPage\MessageScrollPage.vue", "vue", 0, 0, 23, 0, 0, 3, 26
"f:\Project\RBlog\RBlog_F\src\router\index.ts", "TypeScript", 2, 0, 0, 0, 0, 0, 2
"f:\Project\RBlog\RBlog_F\src\styles\about-article-card\about-article-card.css", "PostCSS", 0, 182, 0, 0, 8, 29, 219
"f:\Project\RBlog\RBlog_F\src\styles\about-page\about-page.css", "PostCSS", 0, 87, 0, 0, 2, 12, 101
"f:\Project\RBlog\RBlog_F\src\styles\feeling-card\feeling-card.css", "PostCSS", 0, 67, 0, 0, 8, 13, 88
"f:\Project\RBlog\RBlog_F\src\styles\message-card\message-card.css", "PostCSS", 0, 185, 0, 0, 11, 32, 228
"f:\Project\RBlog\RBlog_F\src\styles\message-page\message-page.css", "PostCSS", 0, 200, 0, 0, 8, 29, 237
"f:\Project\RBlog\RBlog_F\src\styles\message-page\message-scroll-page\message-scroll-page.css", "PostCSS", 0, 8, 0, 0, 0, 1, 9
"f:\Project\RBlog\RBlog_F\src\styles\read-scroll-page\read-scroll-page.css", "PostCSS", 0, 147, 0, 0, 7, 27, 181
"f:\Project\RBlog\RBlog_F\src\types\index.ts", "TypeScript", 21, 0, 0, 0, 3, 3, 27
"f:\Project\RBlog\RBlog_F\vite.config.ts", "TypeScript", 9, 0, 0, 0, 0, 0, 9
"Total", "-", 283, 876, 312, 42, 98, 219, 1830